***********************************************************
*             *                         *       *         *
* * * * * * * * * * * * * * * * * * * * * * * * * * * * * *
*           * * * * * * * * * * * * * * * * * * * * * * * *
* * * * * * * * * * * * * * * * * * * * * * * * * * * * * *
*             *       *           *                       *
* * * * * * * * * * * * * * * * * * * * * * * * * * * * * *
*           * * * * * * * * * * * * * * * * * * * * * * * *
* * * * * * *   * * * * * * * * * * * * * * * * * * * * * *
*                                                         *
* * * * * * * * * * * * * * * * * * * * * * * * * * * * * *
*           * * * * * * * * * * * * * * * * * * * * * * * *
* * * * * * * * * * * * * * * * * * * * * * * * * * * * * *
*             *       *           *                       *
* * * * * * * * * * * * * * * * * * * * * * * * * * * * * *
*           * * * * * * * * * * * * * * * * * * * * * * * *
* * * * * * * * * * * * * * * * * * * * * * * * * * * * * *
*               *       *           *                     *
* * * * * * * * * * * * * * * * * * * * * * * * * * * * * *
***********************************************************