********	
*      *
* * ** *
*      *
* *  * *
*   ** *
*   ** *
*   ** *
* *    *
* *  * *
*    * *
*  * * *
*      *
*   ** *
*  *** *
* **** *
*   ** *
* **** *
* ***  *
*      *
*****  *
********
