****************************************
*       *       *       *   *     *    *
* * * * * * *** ***** * * * * * * ****** 
*     * * * *     *   * * *   * *      * 
*   * *** * ***** * *** * ***** ********
** **     *     *       *     *        * 
*     ********* *** *** * *** *** ****** 
**  *     *     *   * * * * * *       ** 
*   * * * * ********* *   * * * * *** ** 
*         *           *         *  L   *
**************************************** 